NO ./assets/t1.xpm
SO ./assets/t1.xpm
EA ./assets/t1.xpm
WE ./assets/t1.xpm

C 255,255,120
F 120,255,255

11111111111
100000000011
10000000N011
1110011100011
1111001111001
1100011111111
1111111111111
