NO ./assets/t1.xpm
SO ./assets/t1.xpm
EA ./assets/t1.xpm
WE ./assets/t1.xpm

C 255,255,120
F 120,255,255

11111111111111111111111111111111111111111111111111
10000000000000000000000000000000000000000000000001
10000000000000000000000000000000000000000000000001
10000000000000000000000000000000000000000000000001
10000000000000000000000000000000000000000000000001
10000000000000000000000000000000000000000000000001
10000000000000000000000000000000000000000000000001
10000000000000000000000000000000000000000000000001
10000000000000000000000000000000000000000000000001
10000000000000000000000000000000000000000000000001
10000000000000000000000000000000000000000000000001
11111111111111111111111111111111111112111111111111
10000000001000000000001000000000000000000000000001
10000000001000000000001000000000000000000000000001
10000000001000000000002000000000000000000000000001
10000000001000000000001000000000000000000000000001
11111121111111111111211000000000000000000000000001
10000000000000000000001000000000000111110000000001
10000000000000000000001110000000000100010000000001
10000000000000000000001010000000000100010000000001
11111111111111111111121211111111111112111111111111
10000000000000000000000000000000000000000000000001
10000000000000000000000000000000000000000000000001
11111111211111111211111111311111111211111111111121
10000000010000000010000000010000000010000000000001
10000000010000000010000000010000000010000000000001
10000000010000000010000N00010000000010000000000001
10000000010000000010000000010000000010000000000001
11111111111111111111111111111111111111111111111111
