NO ./assets/t1.xpm
SO ./assets/t1.xpm
EA ./assets/t1.xpm
WE ./assets/t1.xpm

C 255,255,120
F 120,255,255

11111111111111111111111111111111111111111111111111
10000000000000000000000000000000000000000000000001
10000000000000000000000000000000000000000000000001
10000000000000000000000000000000000000000000000001
10000000000000000000000000000000000000000000000001
10000000000000000000000000000000000000000000000001
10000000000000000000000000000000000000000000000001
100000000000000000000000000000000000000000000000011111111111111
100000000000000000000000000000000000000000000000010000000000001
100000000000000000000000000000000000000000000000011111111111101
100000000000000000000000000000000000000000000000010000000000101
111111111111111111111111111111111111121111111111110000000000101
100000000010000000000010000000000000000000000000010000000000101
100000000010000000000030000000000000000000000000010000000000101
100000000010000000000020000000000000000000000000030000000000201
100000000010000000000010000000000000000000000000010000000000101
111111211111111111112110000000000000000000000000010000000000101
100000000000000000000010000000000001111100000000010000000000101
100000000000000000000011100000000001000100000000010000000000101
100000000000000000000010100000000001000100000000010000000000101
111111111111111111111212111311111111121111111111110000000000101
100000000000000000000000000000000000000000000000011111111111101
100000000000000000000000000000000000000000000000020000000000001
111111112111111112111111113111111112111111111111211111111111111
10000000010000000010000000010000000010000000000001
10000000010000000010000000010000000010000000000001
10000000010000000010200N00010000000010000000000001
10000000010000000010000000010000000010000000000001
11111111111111111111111111111111111111111111111111
