NO ./assets/t1.xpm
SO ./assets/t1.xpm
EA ./assets/t1.xpm
WE ./assets/t1.xpm

C 255,255,120
F 120,255,255

11111111111111111111111
10000000000000000000001
10000000000000000000001
10000000000000000000001
10000000000000000000001
10000000000000000000001
10000000000000000000001
10000000000000000000001
10000000000000111000001
100000000000001 1000001
10000000000000010000001
10000000000N00000000001
10000000000000000000001
10000000000000000000001
10000000000000000000001
10000000000000000000001
10000000000000000000001
10000000000000000000001
10000000000000000000001
10000000000000000000001
10000000000000000000001
10000000000000000000001
11111111111111111111111
